,G1,G2,G3,G4,G5,G6,G7,G8,G9,G10
G1,11,4,0,0,0,0,1,0,0,2
G2,7,9,0,0,0,0,2,0,0,0
G3,4,8,4,0,0,0,0,0,2,0
G4,4,7,0,3,0,0,0,0,3,1
G5,1,0,0,0,5,0,8,0,2,2
G6,4,2,0,0,0,6,0,0,0,6
G7,0,0,0,0,0,0,18,0,0,0
G8,3,0,0,0,0,0,9,4,1,1
G9,7,0,0,0,0,0,2,0,9,0
G10,6,0,0,0,0,0,1,0,7,4
